16 16 16 16 16 16 16 16 16 16 16 16 16 16 16 16 16 16 16 16 16 16 16 16 16 16 16 16 16 16 16 16 16 16 16 16 16 16 16 16 16 16 16 16 16 16 16 16 16 16
16 16 16 16 16 16 16 16 16 16 16 16 16 16 16 16 16 16 16 16 16 16 16 16 16 16 16 16 16 16 16 16 16 16 16 16 16 16 16 16 16 16 16 16 16 16 16 16 16 16
16 16 16 16 16 16 16 16 16 16 16 16 16 16 16 16 16 16 16 16 2 38 38 38 38 38 2 16 16 16 16 16 16 16 16 16 16 16 16 16 16 16 16 16 16 16 16 16 16 16
16 16 16 16 16 16 16 16 16 16 16 16 16 16 16 16 16 16 16 16 38 38 38 38 38 38 38 16 16 16 16 16 16 16 16 16 16 16 16 16 16 16 16 16 16 16 16 16 16 16
16 16 16 16 16 16 16 16 16 16 16 16 16 16 16 16 16 16 16 16 38 38 38 38 38 38 38 16 16 16 16 16 16 16 16 16 16 16 16 16 16 16 16 16 16 16 16 16 16 16
16 16 16 16 16 16 16 16 16 16 16 16 16 16 16 16 16 16 16 16 38 38 38 38 38 38 38 16 16 16 16 16 16 16 16 16 16 16 16 16 16 16 16 16 16 16 16 16 16 16
16 16 16 16 16 16 16 16 1 1 1 1 1 16 16 16 16 16 16 16 16 38 38 38 38 38 16 16 16 16 16 16 16 16 16 16 16 16 16 16 16 16 16 16 16 16 16 16 16 16
16 16 16 16 16 16 16 16 1 3 3 3 1 16 16 16 16 16 16 16 2 2 2 3 2 2 2 16 16 16 16 16 16 2 3 3 3 3 3 3 3 16 16 16 16 16 16 16 16 16
16 16 16 16 16 16 16 16 1 3 3 3 1 16 16 16 16 16 16 16 16 2 2 3 2 2 16 16 16 16 16 16 16 16 3 3 3 3 3 3 3 3 16 16 16 16 16 16 16 16
16 16 16 16 16 16 16 16 1 3 3 3 1 16 16 16 16 16 16 16 16 16 2 3 2 16 16 16 16 16 16 16 16 16 3 3 3 3 3 3 3 3 16 16 16 16 16 16 16 16
16 16 16 16 16 16 16 16 1 3 3 3 1 16 16 16 16 16 16 16 16 16 16 3 16 16 16 16 16 16 16 16 16 16 3 3 3 3 3 3 3 3 16 16 16 16 16 16 16 16
16 16 16 16 16 16 16 16 1 1 2 1 1 16 16 16 16 16 16 16 16 16 16 3 16 16 16 16 16 16 16 16 16 16 3 3 3 3 3 3 3 3 16 16 16 16 16 16 16 16
16 16 16 16 16 16 16 16 16 16 2 16 16 16 16 16 16 16 16 16 16 16 16 3 16 16 16 16 16 16 16 16 16 16 16 3 3 3 3 3 3 16 16 16 16 16 16 16 16 16
16 16 16 16 16 16 16 16 16 16 2 16 16 16 16 16 16 16 16 16 16 16 16 3 16 16 16 16 16 16 16 16 16 16 16 16 16 16 3 16 16 16 16 16 16 16 16 16 16 16
16 16 16 16 16 16 16 16 16 16 2 16 16 16 16 16 16 16 16 16 16 16 16 3 16 16 16 16 16 16 16 16 16 16 16 16 16 16 3 16 16 16 16 16 16 16 16 16 16 16
16 16 16 16 16 16 16 16 16 16 2 16 16 16 16 16 16 16 16 16 16 16 16 3 16 16 16 16 16 16 16 16 16 16 16 16 16 16 3 16 16 16 16 16 16 16 16 16 16 16
16 16 16 16 16 16 16 16 2 2 2 16 16 16 16 16 16 16 16 16 16 16 16 3 16 16 16 16 16 16 16 16 16 16 16 16 16 16 3 16 16 16 16 16 16 16 16 16 16 16
16 16 16 16 16 16 16 16 2 16 16 16 16 16 16 16 16 16 16 16 16 16 16 3 16 16 16 16 16 16 16 16 16 16 16 16 16 16 3 16 16 16 16 16 16 16 16 16 16 16
16 16 16 16 16 16 16 16 2 16 16 16 16 16 16 16 16 16 16 16 16 16 2 3 2 16 16 16 16 16 16 16 16 16 16 16 3 3 3 16 16 16 16 16 16 16 16 16 16 16
16 16 16 16 16 16 16 16 2 16 16 16 16 16 16 16 16 16 16 16 16 2 2 3 2 2 16 16 16 16 16 16 16 16 16 16 3 16 16 16 16 16 16 16 16 16 16 16 16 16
16 16 16 16 16 16 16 16 2 16 16 16 16 16 16 16 16 16 16 16 2 2 2 3 2 2 2 16 16 16 16 16 16 16 16 3 3 16 16 16 16 16 16 16 16 16 16 16 16 16
16 16 16 16 16 16 16 16 2 16 16 16 3 3 3 3 3 3 3 3 3 3 3 3 3 3 3 3 3 3 3 3 3 3 3 3 3 16 16 16 16 16 16 16 16 16 16 16 16 16
16 16 16 16 16 16 16 16 2 16 16 16 2 16 16 16 16 16 16 16 2 2 2 3 2 2 2 16 16 16 16 16 16 16 16 16 3 16 16 16 16 16 16 16 16 16 16 16 16 16
16 16 16 16 16 16 16 16 2 16 16 16 2 16 16 16 16 16 16 16 16 2 2 3 2 2 16 16 16 16 16 16 16 16 16 16 3 16 16 16 16 16 16 16 16 16 16 16 16 16
16 16 16 16 16 16 16 16 2 16 16 16 2 16 16 16 16 16 16 16 16 16 2 3 2 16 16 16 16 16 16 16 16 16 16 16 3 16 16 16 16 16 16 16 16 16 16 16 16 16
16 16 16 16 16 16 16 16 2 16 16 16 2 2 2 16 16 16 16 16 16 16 16 3 16 16 16 16 16 16 16 16 16 16 16 16 3 16 16 16 16 16 16 16 16 16 16 16 16 16
16 16 16 16 16 16 16 16 2 16 16 16 16 16 2 16 16 16 16 16 16 16 16 3 16 16 16 16 16 16 16 16 16 16 16 16 3 16 16 16 16 16 16 16 16 16 16 16 16 16
16 16 16 16 16 16 16 16 2 16 16 16 16 16 2 16 16 16 16 16 16 16 16 3 16 16 16 2 16 16 16 16 16 16 16 2 3 16 16 16 16 16 16 16 16 16 16 16 16 16
16 16 16 16 16 16 16 16 2 16 16 16 16 16 2 16 16 16 16 16 16 16 16 3 16 16 16 16 16 16 2 16 16 16 16 16 3 16 16 16 16 16 16 16 16 16 16 16 16 16
16 16 16 16 16 16 16 16 2 2 2 2 2 2 2 16 16 16 16 16 16 16 16 3 16 16 16 16 16 16 2 16 16 16 16 16 3 16 16 16 16 16 16 16 16 16 16 16 16 16
16 16 16 16 16 16 16 16 2 2 2 2 2 2 2 16 16 16 16 16 16 16 16 3 16 16 16 16 16 16 16 16 16 16 16 16 2 16 16 16 16 16 16 16 16 16 16 16 16 16
16 16 16 16 16 16 16 16 2 2 2 2 2 2 2 16 16 16 16 16 16 16 16 3 16 16 16 16 16 16 16 16 16 16 16 2 2 2 16 16 16 16 16 16 16 16 16 16 16 16
16 16 16 16 16 16 16 16 2 2 2 2 2 2 2 16 16 16 16 16 16 16 16 3 16 16 16 16 16 16 16 16 16 16 16 2 2 2 16 16 16 16 16 16 16 16 16 16 16 16
16 16 16 16 16 16 16 16 2 2 2 2 2 2 2 16 16 16 16 16 16 16 16 3 16 16 16 16 16 16 16 16 16 16 16 2 2 2 16 16 16 16 16 16 16 16 16 16 16 16
16 16 16 16 16 16 16 16 2 2 2 2 2 2 2 16 16 16 16 16 16 16 16 3 16 16 16 16 16 16 16 16 16 16 16 2 2 2 16 16 16 16 16 16 16 16 16 16 16 16
16 16 16 16 16 16 16 16 16 16 16 16 16 16 16 16 16 16 16 16 16 16 16 3 16 16 16 16 16 16 16 16 16 16 16 2 2 2 16 16 16 16 16 16 16 16 16 16 16 16
16 16 16 16 16 16 16 16 16 16 16 16 16 16 16 16 16 16 16 2 2 2 2 2 2 2 2 16 16 16 16 16 16 16 2 2 2 2 2 16 16 16 16 16 16 16 16 16 16 16
16 16 16 16 16 16 16 16 16 16 16 16 16 16 16 16 16 16 2 2 2 2 2 2 2 2 2 2 16 16 2 16 16 2 2 2 2 2 2 16 16 16 16 16 16 16 16 16 16 16
16 16 16 16 16 16 16 16 16 16 16 16 16 16 16 16 16 16 2 2 2 2 2 2 2 2 2 2 16 16 16 16 2 2 2 2 2 2 2 16 16 16 16 16 16 16 16 16 16 16
16 16 16 16 16 16 16 16 16 16 16 16 16 2 16 16 16 16 2 2 2 2 2 2 2 2 2 2 2 16 16 16 2 2 2 2 2 16 2 16 16 16 16 16 16 16 16 16 16 16
16 16 16 16 16 16 16 16 16 16 16 16 16 16 16 16 16 16 2 2 2 2 2 2 2 2 2 2 2 2 2 2 2 2 16 2 2 2 2 16 16 16 16 16 16 16 16 16 16 16
16 16 16 16 16 16 16 16 16 16 16 16 16 2 16 16 16 16 16 2 2 2 2 2 2 2 2 16 16 16 16 2 2 2 2 2 2 2 2 16 16 16 16 16 16 16 16 16 16 16
16 16 16 16 16 16 16 16 16 16 16 16 16 16 16 16 16 16 16 16 2 2 2 2 2 2 16 16 16 16 16 2 2 16 2 2 16 2 2 16 16 16 16 16 16 16 16 16 16 16
16 16 16 16 16 16 16 16 16 16 16 16 16 16 16 16 16 16 16 16 16 16 16 16 16 16 16 16 16 16 16 16 2 2 2 2 2 2 16 16 16 16 16 16 16 16 16 16 16 16
16 16 16 16 16 16 16 16 16 16 16 16 16 16 16 16 16 16 16 16 16 16 16 16 16 16 16 16 16 16 16 16 16 16 16 16 16 16 16 16 16 16 16 16 16 16 16 16 16 16
16 16 16 16 16 16 16 16 16 16 16 16 16 16 16 16 16 16 16 16 16 16 16 16 16 16 16 16 16 16 16 16 16 16 16 16 16 16 16 16 16 16 16 16 16 16 16 16 16 16
16 16 16 16 16 16 16 16 16 16 16 16 16 16 16 16 16 16 16 16 16 16 16 16 16 16 16 16 16 16 16 16 16 16 16 16 16 16 16 16 16 16 16 16 16 16 16 16 16 16
16 16 16 16 16 16 16 16 16 16 16 16 16 16 16 16 16 16 16 16 16 16 16 16 16 16 16 16 16 16 16 16 16 16 16 16 16 16 16 16 16 16 16 16 16 16 16 16 16 16
16 16 16 16 16 16 16 16 16 16 16 16 16 16 16 16 16 16 16 16 16 16 16 16 16 16 16 16 16 16 16 16 16 16 16 16 16 16 16 16 16 16 16 16 16 16 16 16 16 16
16 16 16 16 16 16 16 16 16 16 16 16 16 16 16 16 16 16 16 16 16 16 16 16 16 16 16 16 16 16 16 16 16 16 16 16 16 16 16 16 16 16 16 16 16 16 16 16 16 16